11111111111
1CCPCCCCCC1
1CCCCCCCCC1
1CCCCCCCCC1
1CCCCCCCCC1
1CCCC0CCCC1
1CCCCCCCCC1
1CCCCCCCCC1
1CCCCECCCC1
11111111111