1111111111111111
1000000000000001
1000000000000001
1000011100000001
1000100010000001
1000011100000001
1000000000000001
1000000000000001
1000000000000001
10000000P0000001
1111111111111111