1111111
1P11111
1111111
11111E1
1111111